**************************************************
**********************    v1   ********************
*******************       v       *****************
*****************         v        ****************
***************           v          **************
*************             v            ************
************              v             ***********
************              v             ***********
***********               v              **********
**********                v               *********
**********                v               *********
*********                 v                ********
********                  v                 *******
*******                   v                  ******
******                    v                   *****
******                    v                   *****
******                    v                   *****
******                    v                   *****
******                    v                   *****
******                    v                   *****
*******                   v                  ******
********                  v                 *******
*********                 v                ********
*********                 v                ********
**********                v               *********
***********               v              **********
***********               v              **********
************              v             ***********
*************             v            ************
**************            v           *************
***************           v          **************
*****************         v        ****************
*******************       v      ******************
*********************    2v   *********************
**************************************************
